F  0,0,255
NO ./textures/redbrick.png

C 225,30,0

SO ./textures/purplestone.png

WE ./textures/colorstone.png


EA ./textures/greystone.png



			1111111111111111111111111
10000000000000000000000001
1011000001110000000000001
1001000000000000000000001
11111111101100000111000001
100000000011000001110110001
1111011111111101110000001001
1111000000000000000101000001
110000001101010111000000001
1000000000000000110000010001
100000S0000000001101010010001
1100000111010101111101111000111
11110111 1110101 101111010001
11111111 1111111       111111
