F  0,0,255
NO ./textures/wall.xpm

C 225,30,0

SO ./textures/wall.xpm

WE ./textures/wall2.xpm


EA ./textures/wall2.xpm

111111111111111111111111
111111000000000000000011
1111111111100000000000001111
1000011111000000000000001111111
11111000000000N0000000011111111
10000000100000111110000001111
11111111111111111111111111111
